11111111111
1C00P0000E1
11111111111