111111
10Q001
1P0CE1
101001
100001
111111
