111111
100001
1P00E1
101001
100001
111111
